######################
           ###########
           ###########
#######         ######
#######       ########
####        ##########
##      ##############
#   ##########      
#   ########       ###
#       #######     ##
##    ##########   ###
##    #########     ##
##                   #
##      ######       #   
######################